Verspätung - försenad
Beruf - profession
Berufe - jobs
Arzt - doctor
Bushaltestelle - busshållplats
die Bedienung - servitören
Der Bauer - bonden
Feuerwehr - brandkår
Ähnlich - similar to - lik/liknande
Wegen - because of - därför att
Außer - utom
einschließlich - inklusive
Nass - blöt
unüblich - ovanlig
eher - rather
Darum(informell) - därför
Daher(formellare)- därför/sålunda/därmed/därav
Deshalb - därför/fördenskull/därmed
Deswegen-that's why-därför/fördenskull/därmed
Sodass (formellare) - så att/således
Folglich - följaktligen
Normalerweise  - vanligtvis
Umzug - flytt 
Leiter - ladder
Leer - empty - tom
die Schüssel - skålen
Alltag - vardag
Zukunft - framtid
Vergangenheit - förflutna
Seife - soap- tvål
Endlich - äntligen
Inzwischen - meanwhile 
Hilfreich - helpful - hjälpsam
Seltsam - Strange
Allgemein - allmänt
Tatsächlich - really
Sinnvoll - meaningful - förnuftigt
Knapp - knappt - kort om - tight
Verantwortlich - ansvarig
ausgezeichnet - Excellent, great
Gemeinsam - gemensam
Fest - firm - fast
Komisch - strange
Hart - hård
Weich - soft (från weak, vag)
Genau-exakt
Klopft - knacka
Erzähl - säga, erzähl mir mehr - berätta mer
Witzig - rolig (vitsig)
zum Lauchen - skratt
Naja- weeeell
ja - ju 
Wahr - true - sann
Wahrheit - sanning
Ich mache mir sorgen - i am worried
Pfeilen - pilar
Was ist los - whats wrong
Abholen - pick up -  plocka upp
Runter-down
Da Drüben - over there-  där borta
Da vorne - over there - där framme
Unten - downstairs (nedan)
Oben - upstairs
Drinnen - inomhus - inside
Von innen - from the inside
Draußen - utomhus
Nebenan - next door - 
Bekantgeben - announce - meddela (tillkännage, kunngöra)
Eindeutig - clear - klart
Eindeutige - entydig
Eindeutiger - klarare
Eindeutigen - entydig
begeistert - upphetsad (geister - spöken)
verfügbar - available - tillgänglig
Zufrieden - nöjd
offensichtlich - uppenbart/självklart 
selbstverständlich- self-evident
Angegeben - angiven/specificerad
unehrliche - oärlig
hinweisen - påpeka
Unabhängig- oberoende
Abhängig - beroende (addicted/dependent)
Nützlich - användbar (nyttig)
Grund - grund anledning
Umgebung - omgivning
Innenstadt- innerstad
Bereichen - områden - areas
Kneipe - bar
Unterkunft - shelter/lodging
Pension - guest house
Fernseher - tv
Vor dem fernseher - framför tvn
Vor- framför
Aufregend - exciting
Kaufhaus - varuhus
individuell - unik, individuell, distinkt
verpflichtet - commited-engagerad
Wahrscheinlich- förmodligen/troligen-probably/likely
aufgekratzt - repig
Durchmachen - genomgå
"und konnte erst Anfang des Jahres jemanden finden" - och kunde inte hitta någon förrän i början av året?
Seitdem - since then?
froh - glad
Wohl -väl (bekväm) - well
Wohl in meiner Haut - bekväm i min hud 
Gehirn - hjärna
Die mär - myten 
 zielen darauf ab, - syftar till
Mittel - medel   (Medium?)
Ich gehe davon aus, dass - jag utgår ifrån att
Nähen - sy
Saß- satt?
Fehlende - missing - felande (felande länk,missing link)
Ebene - level
Bezirk - district
Gegenüber -mittemot
Standort - site, place - plats
Fläche - surface, area - yta - 
Hof - courtyard 
Zentrale - huvudkontor
Das Innere - det inre
Ausland - foreign country/abroad
Ernährung - näring
Dezent- subtilt- subtle
erschütternd- upprörande
beeindruckend - imponerande
Teilweise - delvis
bewundernswert - beundransvärt
Gelassenheit - lugn
Allein - ensam
"wenn du das nochmal machst, bleiben die so stecken“ - ..., kommer de att fastna så här -..., Stay stuck like that
Stecken - fastnat (notera ej verb)
Bleiben - stanna kvar
geeignete - lämplig
geeignteren - mer passande/mer lämplig - more suitable
angemessen - lämplig - appropriate
angemessener - lämpligare/mer lämplig - more appropriate
Mer passande - angemessener
Überzeugt - övertygad
sicherlich - definitivt
unterschreiben - underteckna
vermutlich - förmodligen
Das ändert alles - that changes everything
Es gefällt mir - i like it
wartest - väntar
Erlaubt - tillåten
Verpassen - are missing - saknar
Bauer - farmer
Erkennen - recognize
Ersetzen (ersetzen .. durch ..) - ersätter
Übernehmen- tar över
Erweitern - expanderar
den Opfern - offrena
der unfall - the accident - olyckan
Verwandten - släktingar
Schalter - counter - disken
Verlässt - leaves - lämnar
Warte - wait
Meine - Menar (menar inte att förolämpa)
Schauen - watching - kollar
Prüft - tests - provar
Stehlt - stjäl
Wert - värt - worth 
Die heimat - hemlandet
täglich - dagligen
Getroffen - träffat
kennengelernt - met- träffat
Besonderes - särskiljd
Nur so - undrar bara - just wondering
angenehmen - behaglig
Beliebt - populär
Echt - riktigt
Scheint - verkar
Bereich - område - area/section/field
Erlauben - tillåter
Was passiert danach - what happens afterwards
unterschiedliche - annorlunda
Unterschied - skillnad
Erstellt - skapad
Die sahne - grädden
Nutzer - user
Öffentlichkeit - public
Verein - förening - club 
Verbindungen - connections/links - kontakter/länkar
Gemeinde -community
Den Gesamten - hela ...  - entire
Absolvieren - completed - avslutat / avklarat (speciellt för just skolan/kurser)
Reden - prata - talk/speak
Zustand - status/tillstånd - state/condition
Rache - hämnd
Geprügelter - slagen/misshandlad - beaten
Geprügelt -    slagen/misshandlad  - beaten
Geprügeln - beat up 
Prügel - slå - beat
Prügelt - takter - beats
Beißen - bita - bite
Lächeln/schmunzeln - le - smile
Gott sei Dank - thank god - tack och lov
Ausprobiert - provade 
Probiert - försökte
Miteinander - tillsammans
Unterschiede - skillnader
halt (adv. colloq.) - just / simply
Bieten - offer - erbjuda
Merken - märka - notice
Beraten - advise (her)
Aufmerksamkeit - uppmärksamhet
Käfig - bur
Fußboden - golv
Stock - pinne/käpp/stav eller våning - floor
Geschoss/Geschoß - floor - våning 
Etage - våning - floor (mer formellt)
Dachgeschoß - takvåning? Eller sista våningen
Erdgeschoß - första våningen (ground level)
erstes Untergeschoß - våningen under entréplan
Getan - gjort
Tun - göra
Nächsten - nästa - next
Aushalten - motstå - withstand 
Widerstehen - stå emot - resist
absichtlich - avsiktligt
Böswillig - maliciously
Angebot - erbjudande
Angebote - erbjudanden
Angeboten - erbjuds/erbjudit
Alter - ålder
Schluss - slutsats/slut - conclusion/end
Schlußfolgerung - slutsats
Hast du die Uhrzeit - har du tid
Uhrzeit - tid
Gestern -, yesterday
Zeitraum - period/time period - period/tidsperiod
Sofort - direkt - right away
Dauert - varar - lasts
Dauer - duration
Das dauert - det dröjer
Die Fahrt dauert sechs Tage und fünf Nächte - Resan tar sex dagar och fem nätter
Holen - att hämta
Fast - nästan - almost
Damals - back then
Etwa - ungefär - around
Um wie viel Uhr (kommt ...) - vilken tid (kommer) - at what time
Gleich - snart
Hässlich - ful - ugly
Ich habe Gerade keine Zeit - jag har inte tid just nu
Was machst du gerade? - what are you doing right now?
einzig - endast/enda
einfach - enkelt/bara (det är bara att)
einzig und allein - enbart
einzeln - enskild/enda/avskild
Einzel (noun) - individuell 
Einzelfall - enskilt fall
Ebenfalls - även/dessutom/likaså/också
Es geht gerade erst los - it is just getting started
hereinkommen - kom in
Herein (colloq?) - kom in
Ernst - allvarlig
Eindruck - intryck
unheimlich - kuslig
Angst - ångest/rädsla
immerhin - trots allt
Trotzdem - nevertheless - emellertid/ändå
Beispiel - till exempel
Sogar - även - even
Quasi - nästan
derselbe (der selbe)- samma sak
desselben (des selben) - samma sak
dasselbe (das selbe) - samma sak
trennbar - separable - separerbar
Sogennante - så kallade
sonst - annars
Lieber - snarare
Ungefähr - ungefär
Beziehungsweise - respectively/or rather
Allerdings - visserligen/även/emellertid, fast/fastän
Und zwar - faktiskt/nämligen - namely/in fact
Zwar - fastän
darf (grundform dürfen) - may - får (får jag/man)
Lärm - noise - ljud
gar - alls
Entdecken - upptäcka 
auf welche Art und Weise - på vilket sätt och vis
Immer mit der Ruhe - ta det lugnt
Ärger - Trouble
Schlau - smart
Das Verständnis - understanding - förståelse
Schlimm - bad/severe - illa/dåligt
Das ist schon echt schlimm (colloq. Vad är funktionen av schon här?) - that's really bad
Das ist echt schlimm - that is really bad
Wut - ilska
Obdachlosigkeit - hemlöshet
bestätigen - confirm - bekräfta
wiederholen - upprepa - repeat/revise
Zahlreiche - numerous/copious
Häufig - ofta - frequently
keinerlei - inga (överhuvudtaget) - none (whatsoever)
Dürfen - may
Entscheiden - decide
Mitmachen - vara med - participate
Teilnehmen - delta - participate
sich etwas vorstellen - to imagine something
etwas vorstellen - to introduce something
"Das kannst du laut sagen!" - You can say that again!
Früh - early
Traum - dröm
Weder - neither
durchaus - absolutely/indeed - absolut
Völlig - completely
jedenfalls - i alla fall
Mindestens - at least
Während - while/during - medan
furchtbares - fruktansvärd
Waldeinsamkeit - the feeling of being alone in the woods - bokstavligen skogsensamhet
Die Umwelt - miljön
Die Welt - världen
Der Schwarzwald - black forest, place in grimms stories
Fluss - river
erneut - på nytt
kaum - knappt/nätt och jämt
Außerdem - besides - dessutom, till på köpet
überhaupt - överhuvudtaget
besonders - especially - speciellt/särskilt
Tierwelt - djurriket 
Wiese - äng/plätt
Vorkommen - förekommer
Bach - creek
All diese werkzeuge - alla dessa verktyg
Alle werkzeuge - alla verktyg
die Pflanze - the plant
Landwirtschaft - lantbruk
Das Klima - klimatet
Wüste - desert
Der Empfänger - mottagaren
Der Empfang - mottagning/reception
Empfangen - motta
Der Betreiber - the operator
Entwickeln - utveckla 
Der Entwickeln - the developer - utvecklaren
Der Verfasser - the writer - författaren
Verfassen - författa
Kriegen - erhålla/få/ta emot
Was meinen die Experten - vad menar experterna/vad tycker experterna
Übrigen - övriga/resten - the spare 
Zusätzliche - ytterligare
Einzelnen - enskilda/individuella - individual
Jugendlicher - tonåringar
Verschieden - different - annorlunda
Die verschiedenen ... - de olika/annorlunda
Endlich/letztlich - slutligen
schließlich - slutligt
Zufälliger - slumpmässig - unexpected/random
Richtige - right
Gärten - trädgårdar
Zuständig - responsible - ansvarig
ehemaligen - former - före detta
bisher - so far - hittills/än så länge
gesamte - hela
Termin - appointment
Zu erreichen - att nå
unablässige - oavbruten
Ausdauer - uthållighet
Erraten - gissa
Beigt - sväng
Hinausgehen - to go out - gå ut
Hinaus - ut
Bekannten - famous
Schenkt - giving - ger/skänka
Häufigsten - vanligaste
vermeiden - undvika
ergebnisse - resultat
dringend - brådskande
empfehlung - rekommendation
wer nicht hören will muss fühlen - De som vägrar att följa regler ska känna konsekvenserna
Ansonsten - annars - apart from that/otherwise
Anderemfall - i annat fall
Schon gut - ingen fara - no worries/(it's)all right
Schon wieder - Igen/återigen - yet again
Schon mal - någonsin/någon gång - ever
Schon, aber - ja, men 
Komm schon - kom igen
Denke schon - jag tror det
gleich (adv) - genast
gleich (adj) - likvärdig/lik/liknande
gleichen - likna
wirtschaftlich - ekonomiskt
derselbe - samma/densamma
sich anziehen - klä på sig
sich ausziehen - klä/ta av sig
Darum - därför/av den anledningen - therefore
Ubrigens - förresten/för övrigt - by the way
Soweit - såvitt/redo
Bist du soweit? - är du redo
Aber soweit ich weiß - men såvitt jag känner till
Das kann man wohl sagen - Det skulle man kunna säga
allerdings (konj) - fast/fastän
allerdings (adv) - visserligen/även/emellertid
Was habe ich davon? - vad får jag av det
Zumindest - minst 
Wenigstens - åtminstone
Dadurch - därigenom
Zugleich - på samma gång
Weiterhin - fortsatt/fortfarande/vidare/därutöver 
Geschirr - servis (bestick tallrick etc.)
vergleichen - jämföra
Anschließend - senare
Spicken, Schummeln - fuska
gequatscht - snackat
quatschen - snacka
Reihe nach vor - en efter en
Je nachdem - beroende på
dämlich - dum
Märksproch - talspråk
"Wer nämlich mit H schreibt, ist dämlich" - den som stavar nämlich med H, är dum
nämlich - nämligen
Erneuerungen - förnyelser/renoveringar
mittlerweile - numera/nu för tiden/vid det här laget/nu/under tiden - meanwhile
solche - sådana
ehemalige - förra/öre detta/tidigare
Günstig - gynnsam/billig/förmånlig/lovande - inexpensive
Aßt - åt
Sah .. aus - såg .. ut som
Vorher - innan- beforehand/previously
Zuvor - innan - beforehand/previously
Bevor - innan - beforehand/previously
Wolken - moln
Regenschirm - paraply
las - läste
gab - gav
fanden - found
ging - gick
lag - låg
verlor - förlorade
schlief - sov
ließ - lät
arbeitete - arbetade
Es kam wie es kommen musste - It was bound to happen
Flektieren - böja
Sozusagen - så att säga
immer dann, wenn es - whenever it
nachvollziehen - begripa/förstå sig på
abwarten - avvakta
ungekehrt - omvänd/tvärtom/vice versa
beeinfluss - inflytande/påverkan
beeinflussen - påverka/unfluera
Angleichung - anpassning - adapt
Redewedung - fras
Redewedungen - idiomer
strebsam - ambitiös
erfolg - framgång
erfolgreich - framgångsrik
Rücksicht - hänsyn
Schwierigkeiten - svårigheter 
Fasst - sammanfattar
Überraschend - överaskande
Überraschnung - överraskning
widerspruchslos - without contradiction
Verdauen - smältning
Gleich noch mal - nu igen
kündigen - avbryta/avsluta/säga upp
erwarten - expect - förvänta
nachdenken (denken ... nach) - funderar/tänker efter
Beibringen - lära
üblich - vanlig/vedertagen
Anscheinend - tydligen
Gewesen - har varit
Nun mal - helt enkelt
Ganz sicher - certainly/for sure
spüren - känna
zu ... bekommen - get to  
jene(r/s) - den där, det där (de där)
derjenige - den där personen
Bezeichnen - beteckna
Näher - närmare
wechseln (verb) - växla/byta (variera/skifta). Notera substantiv behöver en artikel. "Das Hotel wechseln"
Überlassen - överlåta/överlämna (lämnar till)
Aufräumen (räumen .. auf) - att städa 
sich enthalten - avstå 
Es wäre Schade - det vore synd
Laune - Humör
Ich freue mich darauf - jag ser fram emot det
(die) Vorwahl - riktnummer, primärval, area code
Das Gespräch - samtalet - conversation/discussion/interview
Kommunikation - kommunikation
sich entspannen - slappna av
Gerücht - rykte/skröna
Bereinigen - korrigera/klara upp
gepierten - pierced
Boden - floor
Paket - package
Geschenke - present/gåvor
Ebenso - likaså (även/dessutom)
Errichten - bygga/upprätta/resa/uppföra
Lächerlich - löjlig
Tastaturen - tangentbord
Festplatten - hårddisk
hinnehmen - acceptera (något av negativ karaktär)
traut - litar på
Haftstrafe - fängelsestraff
verurteilt - dömdes
Nachfragen - inquire - höra efter/efterfråga
die Termine - the appointments
anbieten - offer
wenden - vända
abbrechen - avbryta
aufgeben - ge upp
sich unterhalten - chatta
unterhalten - underhålla
ausgezogen - flyttade ut
unterstützen - stödja/stötta
benötigen - behöva - need/require
erfordern - require (strictly, Orangesaft erfordert Orange)
brauchen - need, can be used as modal verb
Einstellen - anställa
Herunterladen - download
"doch, nein, doch, nein, doch, nein! - jo, nej, jo...
"Was mascht du beruflich" - vad jobbar du med
Unheimliche - kuslig - weird/uncanny
Büro - kontor
Lagerfeuer - lägereld - camp fire
Angeln - meta (fiske)
erwerben - förvärva/skaffa sig/köpa - purchase/buy/aquireerweitern - expand  - bygga ut 
erscheinen - appear/show up
erfolgen - happen/take placu/occur
verlassen - lämna - desolate
vergeben - given out/forgive/awarded
verwenden - use
verdienen - tjäna, förtjäna
lädt - laddar
Jeder wie er mag - to each their own
was teu ich bloß! - what am I doing!
aus Versehen passiert - hände av misstag
Versehen - misstag
gegenseitig - ömsesidig
(etwas steht) ganz weit oben (adv) - (something is) at the very top/högst upp
ganz oben (adj) - högst upp
laden - load
Anhänge - attachments
Geschickt - skickat
Lösche - delete
Lädt der Program hoch - laddar upp programmet
fuhren - drove - färdades
aufgeregt - upphetsad
erfahren (adj) - erfaren/skicklig
erfahren (vb) - uppleva /  erfara, få veta, få reda på, röna 
Dämmerung - skymning
Die Bildung - the education - bildningen
Die Ausbildung - utbildningen
Übungen - övningar
der Universität - the university
Die Note ist weder schlecht noch gut - the grade is neither bad nor good
weder ... noch ... - varken ... eller ... - neither ... nor ...
Forschung - forskning
Praxis - experience, practice - erfarenhet, öva
Das Studium - the studies
eine Lehre - (we learnt) a lesson /  an apprenticeship 
Unterricht haben - to have class (lektion(er))
ausfallen (fallen ... aus) -  to fail/to cancel.
Behalten - behålla
Nachricht - nyhet/meddelande/budskap
Erziehung - uppfostran 
Fachbereich - Department - fakultet/ämnesområde
sich überlegen - att överväga - to think about something/to deliberate
überlegen - ponder
Ich will es mir mal überlegen - I want to think about it for a while
lch werde es mir durch den Kopf gehen lassen - I want to think about it for a while
Weiterbildung - vidareutbildning
Die alte Schule wurde zum Kindergarten - the old school became a kindergarten
geschlossen - låst/stängt/slutit
gegangen  - gått/lämnat/åkt
komplett im Eimer - helt trasig/fullständigt utmattad
ergänzen - komplettera/lägg till/tillägga/färdigställ
einladung - inbjudan
einladen (er lädt ein) - bjuda in
empfehler - rekommendera
er empfielt - han rekommenderar
bequem - bekväm
der Wortschatz - ordförråd
das Vokabular - vokabulär
Auskunft - uppgift (info)
Kenntnisse - kännedom, kunskap - skills/knowledge
Kenntnis - kunskap 
Erfindung - uppfinning
gingen Hand in Hand - går hand i hand
umkrempeln (krempeln ... um) - vända ut och in på - to turn inside out, to change (fundamentally, from the ground up)
messen - mäter
Einteilung - indelning
überwiegend - övervägande
folgendermaßen - på följande vis/sålunda - as follows
Kunststoff - plastic
Holz - wood
Ich bitte sie um verzeihung - jag ber er om förlåtelse
die Meldung - delgivning, rapport, meddelande
Begründen - rättfärdiga
Begründung - anledning/motivering - reason/grounds
veröffentlichen - publicera/offentliggöra
Bestätigung - bekräftelse
Mitteilung - meddelande
befinden sich - befinner sig
lohnen sich - lönar sig
ergab sich - gav upp (sig själv)
Interesiert sich - interessera sig
sich melden - to get in touch (e.g. uns melden)
hübsch - pretty
Geschäftsschluss - stängningstid
es bewegt sich - det rör på sig
Sich holen - going to get 
Freut ihr euch - are you looking forward to
sich anschauen - check out 
Haben sich gesetz - har suttit sig ner
lch werde mir das ganz genau anschauen - i will look at that very closely
Man sieht sich in der Schule. - see you at school
sich sorgen - worry - oroa sig
sich eintragen - register/sign in/enroll
sich anmelden - anmäla sig
lch erinnere mich nicht an sie - I do not remember them
sich verlaufen - gå vilse
sich ansehen - to take a look at, check out. It suggests inspection or intent to find/ search for something
ansehen - to look at
verdächtigen - suspected
verdächtigung - suspect (noun)
Erlaubnis - tillåtelse
eignet sich hervorragend - is ideal
Pflege - vård/underhåll
Auslauf - motion
Einsetzen - tillsätta, insätta/sätta in
Einfügen - infoga/inkludera
Zuverlässig - pålitlig/tillförlitlig
annehmen (nehmen ... an) - anta, acceptera, receive
ablehen (lehnt ... ab) - decline, reject, turn down
entlehnen - låna 
verleihen - lend - låna ut
ausleihen - lend out - låna ut
Ich kann kaum stehen, geschweige denn rennen! - i can barely stand, let alone run!
Geschweige - för att inte nämna
vermissen - sakna
die Geschichte - the tale 
Zustimmung - approval - samtycke/instämmande/medhåll
Einwilligung - samtycke
Übereinstimmung - överensstämmelse
Einigung - Överenskommelse 
Zaun - fence
Decke - blanket - täcke/filt
Schwanger - gravid
Berichte - reports - rapporter
Meinungen - opinions
Zeichen - tecken
Vorab - firstly
Die bilanz - the balance
rauszuheben - stand out
Mehrzahl, vielzahl - flertal
Das gleicht sich aus - it cancels itself out
Das Verzeichnis - the index - förteckning/index
im begriff sein zu - to be about to
Ex: im begriff zu gehen - about to leave
im begriff - on the edge / on the verge 
Zusammenfassung - sammanfattning
Betreiber - operators
Rechtsanwälte - advokat - lawyers